##############################
#........##........##........#
#........##........##........#
#........##........##........#
#........##........##........#
#........##........##........#
#........##........##........#
#........##........##........#
#####.#########.#########.####
..............................
..............................
..............................
#####.#########.#########.####
#........##........##........#
#........##........##........#
#........##........##........#
#........##........##........#
#........##........##........#
#........##........##........#
#........##........##........#
